کلمه لا اله الا الله حصنی فمن دخل حصنی امن من عذابی|بحارالانوار، ج ۳، ص ۷
النظافة من الإيمان|کنزالعمال، حدیث ۲۷۶۰
رحم الله عبداً قال خیراً فغنم او سکت فسلم|تحف العقول، ص ۸۷
اطلبوا العلم من المهد الی اللحد|بحارالانوار، ج ۱، ص ۱۷۷
الصبر مفتاح الفرج|غررالحکم، حدیث ۲۳۴
المؤمن مرآة المؤمن|الکافی، ج ۲، ص ۱۶۶
خیر الامور اوسطها|نهج البلاغه، حکمت ۴۳
من حسن اسلام المرء ترکه ما لا یعنیه|سنن الترمذی، حدیث ۲۳۱۷
الملائکة تصلی علی معلم الناس الخیر|سنن الترمذی، حدیث ۲۶۸۵
الدنیا مزرعة الآخرة|غررالحکم، حدیث ۴۲۵۶
ما زال جبرئیل یوصینی بالجار حتی ظننت انه سیورثه|صحیح البخاری، حدیث ۶۰۱۵
الکلمة الطیبة صدقة|صحیح مسلم، حدیث ۱۰۰۹
من ستر مسلماً ستره الله یوم القیامة|صحیح البخاری، حدیث ۲۴۴۲
الایمان معرفة بالقلب و اقرار باللسان و عمل بالارکان|بحارالانوار، ج ۶۶، ص ۷۱
ان الله یحب اذا عمل احدکم عملاً ان یتقنه|کنزالعمال، حدیث ۹۱۲۷
اللهم ارزقنی حسن الخاتمة|دعای مأثور
اکثر ما یدخل الناس النار الفم و الفرج|سنن الترمذی، حدیث ۲۰۰۴
من حسن ظنه بالله رضی الله عنه|شعب الایمان، حدیث ۳۹۵
الصلح سید الاحکام|وسائل الشیعة، ج ۱۵، ص ۳۰۳
اللهم اجعلنی فی درکة المتقین|دعای مأثور
خیرکم من تعلم القرآن و علمه|صحیح البخاری، حدیث ۵۰۲۷
ما نقص مال من صدقة|صحیح مسلم، حدیث ۲۵۸۸
الدنیا سجن المؤمن و جنة الکافر|صحیح مسلم، حدیث ۲۹۵۶
من کان فی حاجة اخیه کان الله فی حاجته|صحیح مسلم، حدیث ۲۵۸۰
انما الأعمال بالنیات|صحیح البخاری، حدیث ۱
اللهم بارک لی فی الوقت|دعای مأثور
المسلم من سلم المسلمون من لسانه و یده|صحیح البخاری، حدیث ۱۰
اللهم انی اعوذ بک من الهم و الحزن|صحیح البخاری، حدیث ۶۳۶۳
ان الله جمیل یحب الجمال|صحیح مسلم، حدیث ۹۱
اللهم اجعلنی خیراً مما یظنون|دعای مأثور
